XXXXXXXXXXXXXXXXXXXXXXXXXXXXXXXXXXXXXXXXXXXXXXXXXXXXXXXXXXXXXXXXXXXXXXXXXXXXXXXXXX
X________________________________________________________________________________X
X________________________________________________________________________________X
X________________________________________________________________________________X
X________________________________________________________________________________X
X________________________________________________________________________________X
X________________________________________________________________________________X
X________________________________________________________________________________X
X________________________________________________________________________________X
X________________________________________________________________________________X
X________________________________________________________________________________X
X________________________________________________________________________________X
X________________________________________________________________________________X
X_______________________________X_____________X__________________________________X
X_______________________________X_____________X__________________________________X
X_______________________________X_____________X__________________________________X
X_______________________________X_____________X__________________________________X
X_______________________________X_____________X__________________________________X
X_______________________________X_____________X__________________________________X
X_______________________________X_____________X__________________________________X
X_______________________________X_____________X__________________________________X
XS______________________________X_____________X_________________________________0X
X_______________________________X_____________X__________________________________X
X_______________________________X_____________X__________________________________X
X_______________________________X_____________X__________________________________X
X_______________________________X_____________X__________________________________X
X_______________________________X_____________X__________________________________X
X_______________________________X_____________X__________________________________X
X_______________________________X_____________X__________________________________X
X_______________________________X_____________X__________________________________X
X________________________________________________________________________________X
X________________________________________________________________________________X
X________________________________________________________________________________X
X________________________________________________________________________________X
X________________________________________________________________________________X
X________________________________________________________________________________X
X________________________________________________________________________________X
X________________________________________________________________________________X
X________________________________________________________________________________X
X________________________________________________________________________________X
X________________________________________________________________________________X
X________________________________________________________________________________X
X________________________________________________________________________________X
XXXXXXXXXXXXXXXXXXXXXXXXXXXXXXXXXXXXXXXXXXXXXXXXXXXXXXXXXXXXXXXXXXXXXXXXXXXXXXXXXX