XXXXXXXXXXXXXXXXXXXXXXXXXXXXXXXXXXXXX
X___________________________________X
X___________________________________X
X___________________________________X
X_________________X__XX_____________X
X_________________X__XX_____________X
X_________________X__XX_____________X
X_________________X__XX_____________X
X_________________X__XX_____________X
X_________________X__XX_____________X
X_________________X__XX_____________X
X_S_______________X__XX____________0X
X_________________X__XX_____________X
X_________________X__XX_____________X
X_________________X__XX_____________X
X_________________X__XX_____________X
X_________________X__XX_____________X
X_________________X__XX_____________X
X_________________X__XX_____________X
X_________________X__XX_____________X
X_________________X__XX_____________X
X___________________________________X
X___________________________________X
X___________________________________X
X___________________________________X
X___________________________________X
XXXXXXXXXXXXXXXXXXXXXXXXXXXXXXXXXXXXX