XXXXXXXXXXXXXXXXXXXXXXXXXXXXXXXXXXXXXXXXXX
XS____X_________________________X_XX_____X
X___X_____X______________________________X
X______XX___________________X____________X
X_______X_________________________X______X
X____XX____________X___X__________X______X
X__________X_____________X_____X______X__X
X_____________________X___X__X___________X
X___X______X_______X________X__________X_X
X___________________X___X___________X___XX
X_X______________X__X____________________X
X___________X___________X______X_________X
X____X___________________________________X
X_____X_____________________X______X_X___X
X______X______________________________X__X
X_______X____________X___X__________X____X
X_______X______________X_____XX__________X
X__________X___________X_X_______________X
X________X___X_____________XX______X___X_X
X___XX_X_____X__X___XXX____________X_X_X_X
X__X___XX_________X______________________X
X___________X____X__XX___________________X
X_______X__X______XX___X_______X_________X
XX________________X______________________X
X_______X___________________________X____X
X___________X________X___X________X______X
X___X_________X__________________________X
X___XX________________X______X___________X
X_____X___________X_______________X______X
X_______X__X_________X___X______________XX
X___X_____X______________X__X___________XX
X_____X_X_________X______________X__X____X
X_X________XX____________X_______________X
XX_____X__________X__X______________X_X__X
X_X_____________________________________XX
X_______X___X_____________X______________X
X________X_X_____X___X______________X____X
X______X__X_____X___________X____________X
XX____________X___X_X________X________X__X
X_XX__________________X_X_X______X_______X
X____________X_________________________0XX
XXXXXXXXXXXXXXXXXXXXXXXXXXXXXXXXXXXXXXXXXX